1
0
................
................
................
................
................
.........RRR....
.........R..R...
.........R..R...
.........RRR....
.........R.R....
.........R..R...
................
................
................
................
................