2
-2
..........RRR...
..RR............
..............RR
...............R
.....RRR.......R
...............R
...........R....
...RRR..........
R...............
R.............RR
R...............
......R.........
..............R.
................
RR.............R
.............RRR