1
-1
................
................
................
................
....R...........
....R.......R...
....R.....R...R.
....R.......R...
....RRR.........
........RRR.....
...........RR...
...........RR...
...........RR...
...........RR...
................
................