2
0
RR..........RR..
.....RR.........
............RR..
................
....RRRRR......R
..R............R
..R............R
..R............R
................
................
.....RRR.R.R.R.R
................
.......R........
RRRRRRRR........
................
........RRR.....