0
-1
................
................
................
................
....R...........
....R...........
....RRR.........
....R.R.........
....RRR.........
....R...........
....RRR.........
....RRR.........
....RRR.........
................
................
................