1
1
................
................
................
...RRRRR........
...RRRRR........
...RR...........
...RR...........
...RR...........
...RRRRR........
...RRRRR........
................
................
................
................
................
................