2
1
................
................
................
................
....R.....R.....
....R.....R.....
....R.....R.....
..R........R....
...R......R.....
....R....R......
.....RRRR.......
................
................
..RR......RR....
................
..RR......RR....