1
-2
.R...........RRR
................
....RRR.........
............RRRR
.....RR........R
...............R
RR.............R
...............R
R...............
..............RR
....RRR.........
......R........R
......R.........
......RRRR......
...............R
RR..............