-1
1
................
................
................
...RRRRR........
...RRRRR........
...RR.RR........
...RR.RR........
...RR...........
...RRRRR........
...RRRRR........
................
................
................
................
................
................