2
-1
..............RR
..RRRRR........R
.............RR.
................
....R...........
....R...........
....R...........
...............R
...............R
...............R
........R......R
........R......R
........R.......
R...............
R...............
R...............