0
1
.......R........
......RRR.......
...RRRRRRR......
.......R........
.......R........
................
................
..............RR
................
...............R
.R..............
.RRRRRRR........
.RRR.R.R........
................
................
................