-2
-1
..RRRR..........
.............R..
................
.......RR.......
.............RR.
RR..............
................
......RRRRR.....
..............R.
R...............
................
.............R..
..RRRRR.........
................
................
............RR..