-1
-2
..RRRRR.........
..R............R
..R............R
RRR............R
............RRRR
..RRRR..........
.....R..........
.....R..........
............RRRR
................
................
..RRR......RRRRR
...........R....
R..........R....
R........RRR....
RRRR............