-2
-2
RRRR.....RRR....
.........R......
................
................
.RRRRRRRRRRRRRRR
.....R..........
.....R..........
...........RRRRR
..R.............
..R.............
..RRR........RRR
....R..........R
....R.....R....R
..........R....R
..R............R
RRR............R