-1
-1
...............R
...............R
...............R
...............R
....R..........R
....R..........R
....R..........R
....R..........R
....RRR........R
...............R
...............R
...............R
...............R
...............R
...............R
........RRRRRRRR