0
-2
..............RR
................
.....R..........
...RRR..........
................
................
R..............R
R..............R
R..............R
...............R
......RRRRRRRRRR
................
RRR.............
................
................
....RRR.........