-2
0
RRRRR...........
R...............
R...........RRRR
R..............R
...............R
....RRR.........
...........RRRRR
...R............
...R............
...RRR..........
................
.R.......RRR....
.R...........RRR
.R.............R
.RRR............
................